NO ./maps/greystone.xpm
SO ./maps/greystone.xpm
WE ./maps/greystone.xpm
EA ./maps/greystone.xpm
F 220,100,205
C 225,30,0
111111111111111111111111111111
100000000000000000000000000001
100000000000N00000000000000001
111111111111111111111111111111
