NO ./maps/n.xpm
SO ./maps/s.xpm
WE ./maps/w.xpm
EA ./maps/e.xpm
F 67,70,91
C 124,177,255

11111111
100111N1
10001001
10001001
10000001
11111111
